#Europa

MAU = countries/Mauretania.txt
BRV = countries/BavarianRevolt.txt
GRV = countries/GermanRevolt.txt
VIK = countries/Vikings.txt
THC = countries/ThreeCrowns.txt
ANW = countries/Antwerp.txt
PES = countries/Pest.txt
SZZ = countries/Szczecin.txt
BRG = countries/Briesgau.txt
FRK = countries/Franconia.txt
HEI = countries/Heidelberg.txt
BMB = countries/Bamberg.txt
PAS = countries/Passau.txt
ZNA = countries/Znaim.txt
WIE = countries/Wien.txt
EPP = countries/Eppenstein.txt
GRZ = countries/Graz.txt
KRT = countries/Karnten.txt
LAV = countries/Lavant.txt
KRN = countries/Krain.txt
IST = countries/Istria.txt
TST = countries/Triest.txt
STA = countries/SanktAnton.txt
RHE = countries/Rheineck.txt
DOU = countries/Donauworth.txt
FRE = countries/Freising.txt
LDS = countries/Landshut.txt
KRH = countries/Kirchroth.txt
AMB = countries/Amberg.txt
RGS = countries/Regensburg.txt
WTZ = countries/Wetzlar.txt
GTT = countries/Gottingen.txt
ARN = countries/Arnsberg.txt
PDB = countries/Paderborn.txt
ACM = countries/Achim.txt
MPP = countries/Meppen.txt
BEG = countries/Berg.txt
KBL = countries/Koblenz.txt
SJE = countries/Sjaelland.txt
SKN = countries/Scania.txt
ALK = countries/Alkmaar.txt
BRD = countries/Breda.txt
GNT = countries/Gent.txt
ARR = countries/Arras.txt
LNN = countries/Loon.txt
AMS = countries/Amiens.txt
SNS = countries/Sens.txt
TRO = countries/Troyes.txt
ANJ = countries/Anjou.txt
AUR = countries/Auxerre.txt
NAN = countries/Nantes.txt
REN = countries/Rennes.txt
BES = countries/Besancon.txt
BRN = countries/Bern.txt
UPB = countries/UpperBurgundy.txt
FOR = countries/Forcalquier.txt
POI = countries/Poitou.txt
AQT = countries/Aquitaine.txt
BEA = countries/Bearn.txt
ROS = countries/Rosello.txt
URG = countries/Urgell.txt
CLT = countries/Calatrava.txt
SAN = countries/Santiago.txt
SRK = countries/Sarkel.txt
BRY = countries/Bryansk.txt
VIT = countries/Vitebsk.txt
VLA = countries/Vladimir.txt
AUK = countries/Auksztota.txt
TGR = countries/Tangier.txt
BNV = countries/Benevento.txt
GWY = countries/Gwynedd.txt
DEH = countries/Deheubarth.txt
GLW = countries/Galloway.txt
CTH = countries/Caithness.txt
BCH = countries/Buchan.txt
DEV = countries/Devon.txt
HER = countries/Hertogenbosch.txt
VRD = countries/Verdun.txt
FRB = countries/Fribourg.txt
CRC = countries/Carcossone.txt

#Ameryka Pln.
ANL = countries/Antilles.txt